BBBBBBBBBBBBBBBBBBBBBBBBBBBBBB
B                            B
B    H    J                  B
BXXXXHXXTCXXCTX XXXXXXXXXXXX B
BXXXXHXXTXX XXX XXXXX XXXXXXXB
BXXXXH  TXX   X   XXX XXXSSXXB
BXXSSXXXTXXXX GXX XXX XXXXXXXB
BXXXXXXXTXXXX CCX XXXXXX XXXXB
BXXXXXXXTXXXX XXX   XXXX XXXXB
BXXXXXXXTX GX    XX XX  XXXXXB
BXXXXXXXTXC XXXG XX CXXXG  GXB
BXXXXGSCTXXXXXXX XX XXXXSXXXXB
BXXSGCUXXXXXX XX XX SXXXX    B
BXXXXXXXXXXXXXGG XXXXXXSXXGX B
BXXXXXXXGGXXXXXXTTGUXXXXXXXTXB
BXGCCCXXXXXXXXXXXXXXXXXUXXXUXB
BXXXXXXXXXXXXXXXXXXXXXXXXXXXXB
BXXXXXXXXXXXXXXXXXXXXXXXXXXXXB
BXXXXXXXXXXXXXXXXXXXXXXXXXXXXB
BBBBBBBBBBBBBBBBBBBBBBBBBBBBBB
